"filename", "language", "C#", "UnityShader", "JSON", "Markdown", "comment", "blank", "total"
"c:\Users\Dan\Dev\Unity Projects\MultiUnitPathfinding\Assets\Quirky Series Ultimate\_Scripts\QuirkySeriesDemo.cs", "C#", 180, 0, 0, 0, 19, 34, 233
"c:\Users\Dan\Dev\Unity Projects\MultiUnitPathfinding\Assets\Quirky Series Ultimate\_Scripts\RotateOnScroll.cs", "C#", 15, 0, 0, 0, 1, 4, 20
"c:\Users\Dan\Dev\Unity Projects\MultiUnitPathfinding\Assets\Quirky Series Ultimate\_Shader\SoftSurface.shader", "UnityShader", 0, 33, 0, 0, 1, 5, 39
"c:\Users\Dan\Dev\Unity Projects\MultiUnitPathfinding\Assets\Quirky Series Ultimate\_Shader\ToonRamp.shader", "UnityShader", 0, 46, 0, 0, 6, 11, 63
"c:\Users\Dan\Dev\Unity Projects\MultiUnitPathfinding\Assets\Supercyan Character Pack Free Sample\Scripts\AccessoryLogic.cs", "C#", 11, 0, 0, 0, 0, 3, 14
"c:\Users\Dan\Dev\Unity Projects\MultiUnitPathfinding\Assets\Supercyan Character Pack Free Sample\Scripts\AccessoryWearLogic.cs", "C#", 95, 0, 0, 0, 0, 15, 110
"c:\Users\Dan\Dev\Unity Projects\MultiUnitPathfinding\Assets\Supercyan Character Pack Free Sample\Scripts\DemoFree.cs", "C#", 72, 0, 0, 0, 0, 21, 93
"c:\Users\Dan\Dev\Unity Projects\MultiUnitPathfinding\Assets\Supercyan Character Pack Free Sample\Scripts\FreeCameraLogic.cs", "C#", 48, 0, 0, 0, 0, 13, 61
"c:\Users\Dan\Dev\Unity Projects\MultiUnitPathfinding\Assets\Supercyan Character Pack Free Sample\Scripts\SimpleSampleCharacterControl.cs", "C#", 168, 0, 0, 0, 6, 41, 215
"c:\Users\Dan\Dev\Unity Projects\MultiUnitPathfinding\Assets\Supercyan Character Pack Free Sample\Shaders\Legacy\CelShader.shader", "UnityShader", 0, 203, 0, 0, 70, 9, 282
"c:\Users\Dan\Dev\Unity Projects\MultiUnitPathfinding\Assets\Supercyan Character Pack Free Sample\Shaders\SupercyanShader.shader", "UnityShader", 0, 33, 0, 0, 0, 6, 39
"c:\Users\Dan\Dev\Unity Projects\MultiUnitPathfinding\Assets\Supercyan Character Pack Free Sample\Shaders\SupercyanShaderLighting.cginc", "UnityShader", 0, 28, 0, 0, 0, 10, 38
"c:\Users\Dan\Dev\Unity Projects\MultiUnitPathfinding\Assets\TextMesh Pro\Shaders\TMP_Bitmap-Custom-Atlas.shader", "UnityShader", 0, 109, 0, 0, 2, 33, 144
"c:\Users\Dan\Dev\Unity Projects\MultiUnitPathfinding\Assets\TextMesh Pro\Shaders\TMP_Bitmap-Mobile.shader", "UnityShader", 0, 112, 0, 0, 3, 31, 146
"c:\Users\Dan\Dev\Unity Projects\MultiUnitPathfinding\Assets\TextMesh Pro\Shaders\TMP_Bitmap.shader", "UnityShader", 0, 109, 0, 0, 2, 33, 144
"c:\Users\Dan\Dev\Unity Projects\MultiUnitPathfinding\Assets\TextMesh Pro\Shaders\TMP_SDF Overlay.shader", "UnityShader", 0, 243, 0, 0, 4, 71, 318
"c:\Users\Dan\Dev\Unity Projects\MultiUnitPathfinding\Assets\TextMesh Pro\Shaders\TMP_SDF SSD.shader", "UnityShader", 0, 241, 0, 0, 4, 66, 311
"c:\Users\Dan\Dev\Unity Projects\MultiUnitPathfinding\Assets\TextMesh Pro\Shaders\TMP_SDF-Mobile Masking.shader", "UnityShader", 0, 188, 0, 0, 10, 50, 248
"c:\Users\Dan\Dev\Unity Projects\MultiUnitPathfinding\Assets\TextMesh Pro\Shaders\TMP_SDF-Mobile Overlay.shader", "UnityShader", 0, 183, 0, 0, 8, 50, 241
"c:\Users\Dan\Dev\Unity Projects\MultiUnitPathfinding\Assets\TextMesh Pro\Shaders\TMP_SDF-Mobile SSD.shader", "UnityShader", 0, 82, 0, 0, 4, 21, 107
"c:\Users\Dan\Dev\Unity Projects\MultiUnitPathfinding\Assets\TextMesh Pro\Shaders\TMP_SDF-Mobile.shader", "UnityShader", 0, 183, 0, 0, 8, 50, 241
"c:\Users\Dan\Dev\Unity Projects\MultiUnitPathfinding\Assets\TextMesh Pro\Shaders\TMP_SDF-Surface-Mobile.shader", "UnityShader", 0, 103, 0, 0, 8, 28, 139
"c:\Users\Dan\Dev\Unity Projects\MultiUnitPathfinding\Assets\TextMesh Pro\Shaders\TMP_SDF-Surface.shader", "UnityShader", 0, 122, 0, 0, 4, 33, 159
"c:\Users\Dan\Dev\Unity Projects\MultiUnitPathfinding\Assets\TextMesh Pro\Shaders\TMP_SDF.shader", "UnityShader", 0, 243, 0, 0, 4, 71, 318
"c:\Users\Dan\Dev\Unity Projects\MultiUnitPathfinding\Assets\TextMesh Pro\Shaders\TMP_Sprite.shader", "UnityShader", 0, 97, 0, 0, 0, 20, 117
"c:\Users\Dan\Dev\Unity Projects\MultiUnitPathfinding\Assets\TextMesh Pro\Shaders\TMPro.cginc", "UnityShader", 0, 63, 0, 0, 2, 20, 85
"c:\Users\Dan\Dev\Unity Projects\MultiUnitPathfinding\Assets\TextMesh Pro\Shaders\TMPro_Mobile.cginc", "UnityShader", 0, 122, 0, 0, 2, 34, 158
"c:\Users\Dan\Dev\Unity Projects\MultiUnitPathfinding\Assets\TextMesh Pro\Shaders\TMPro_Properties.cginc", "UnityShader", 0, 62, 0, 0, 10, 14, 86
"c:\Users\Dan\Dev\Unity Projects\MultiUnitPathfinding\Assets\TextMesh Pro\Shaders\TMPro_Surface.cginc", "UnityShader", 0, 76, 0, 0, 7, 19, 102
"c:\Users\Dan\Dev\Unity Projects\MultiUnitPathfinding\Assets\TextMesh Pro\Sprites\EmojiOne.json", "JSON", 0, 0, 155, 0, 0, 2, 157
"c:\Users\Dan\Dev\Unity Projects\MultiUnitPathfinding\Assets\danzabarr\DEMO\Editor\DecorationsEditor.cs", "C#", 17, 0, 0, 0, 0, 5, 22
"c:\Users\Dan\Dev\Unity Projects\MultiUnitPathfinding\Assets\danzabarr\DEMO\Editor\MapEditor.cs", "C#", 17, 0, 0, 0, 0, 5, 22
"c:\Users\Dan\Dev\Unity Projects\MultiUnitPathfinding\Assets\danzabarr\DEMO\Scripts\AbstractTerrainGenerator.cs", "C#", 85, 0, 0, 0, 41, 24, 150
"c:\Users\Dan\Dev\Unity Projects\MultiUnitPathfinding\Assets\danzabarr\DEMO\Scripts\Agent.cs", "C#", 82, 0, 0, 0, 0, 25, 107
"c:\Users\Dan\Dev\Unity Projects\MultiUnitPathfinding\Assets\danzabarr\DEMO\Scripts\AgentTask.cs", "C#", 9, 0, 0, 0, 0, 2, 11
"c:\Users\Dan\Dev\Unity Projects\MultiUnitPathfinding\Assets\danzabarr\DEMO\Scripts\Area.cs", "C#", 54, 0, 0, 0, 6, 15, 75
"c:\Users\Dan\Dev\Unity Projects\MultiUnitPathfinding\Assets\danzabarr\DEMO\Scripts\BatchRenderer.cs", "C#", 62, 0, 0, 0, 3, 14, 79
"c:\Users\Dan\Dev\Unity Projects\MultiUnitPathfinding\Assets\danzabarr\DEMO\Scripts\Boid.cs", "C#", 63, 0, 0, 0, 2, 13, 78
"c:\Users\Dan\Dev\Unity Projects\MultiUnitPathfinding\Assets\danzabarr\DEMO\Scripts\CameraController.cs", "C#", 54, 0, 0, 0, 4, 15, 73
"c:\Users\Dan\Dev\Unity Projects\MultiUnitPathfinding\Assets\danzabarr\DEMO\Scripts\CharacterControllerTest.cs", "C#", 30, 0, 0, 0, 4, 11, 45
"c:\Users\Dan\Dev\Unity Projects\MultiUnitPathfinding\Assets\danzabarr\DEMO\Scripts\Chunk.cs", "C#", 256, 0, 0, 0, 151, 56, 463
"c:\Users\Dan\Dev\Unity Projects\MultiUnitPathfinding\Assets\danzabarr\DEMO\Scripts\CliffDecorations.cs", "C#", 44, 0, 0, 0, 3, 11, 58
"c:\Users\Dan\Dev\Unity Projects\MultiUnitPathfinding\Assets\danzabarr\DEMO\Scripts\CollisionTest.cs", "C#", 239, 0, 0, 0, 7, 57, 303
"c:\Users\Dan\Dev\Unity Projects\MultiUnitPathfinding\Assets\danzabarr\DEMO\Scripts\Decorations.cs", "C#", 115, 0, 0, 0, 8, 31, 154
"c:\Users\Dan\Dev\Unity Projects\MultiUnitPathfinding\Assets\danzabarr\DEMO\Scripts\Dialogue.cs", "C#", 187, 0, 0, 0, 23, 38, 248
"c:\Users\Dan\Dev\Unity Projects\MultiUnitPathfinding\Assets\danzabarr\DEMO\Scripts\IHeightMap.cs", "C#", 7, 0, 0, 0, 0, 3, 10
"c:\Users\Dan\Dev\Unity Projects\MultiUnitPathfinding\Assets\danzabarr\DEMO\Scripts\IOnValidateListener.cs", "C#", 7, 0, 0, 0, 1, 2, 10
"c:\Users\Dan\Dev\Unity Projects\MultiUnitPathfinding\Assets\danzabarr\DEMO\Scripts\Map.cs", "C#", 184, 0, 0, 0, 25, 32, 241
"c:\Users\Dan\Dev\Unity Projects\MultiUnitPathfinding\Assets\danzabarr\DEMO\Scripts\MapGeneratorBase.cs", "C#", 626, 0, 0, 0, 77, 163, 866
"c:\Users\Dan\Dev\Unity Projects\MultiUnitPathfinding\Assets\danzabarr\DEMO\Scripts\Node.cs", "C#", 14, 0, 0, 0, 0, 3, 17
"c:\Users\Dan\Dev\Unity Projects\MultiUnitPathfinding\Assets\danzabarr\DEMO\Scripts\NoiseSettings.cs", "C#", 55, 0, 0, 0, 0, 12, 67
"c:\Users\Dan\Dev\Unity Projects\MultiUnitPathfinding\Assets\danzabarr\DEMO\Scripts\PerlinNoise.cs", "C#", 43, 0, 0, 0, 0, 8, 51
"c:\Users\Dan\Dev\Unity Projects\MultiUnitPathfinding\Assets\danzabarr\DEMO\Scripts\Ramp.cs", "C#", 56, 0, 0, 0, 0, 10, 66
"c:\Users\Dan\Dev\Unity Projects\MultiUnitPathfinding\Assets\danzabarr\DEMO\Scripts\RandomTransform.cs", "C#", 92, 0, 0, 0, 0, 13, 105
"c:\Users\Dan\Dev\Unity Projects\MultiUnitPathfinding\Assets\danzabarr\DEMO\Scripts\ScriptElementPatterns.cs", "C#", 69, 0, 0, 0, 2, 14, 85
"c:\Users\Dan\Dev\Unity Projects\MultiUnitPathfinding\Assets\danzabarr\DEMO\Scripts\TerrainGenerationSettings.cs", "C#", 26, 0, 0, 0, 0, 5, 31
"c:\Users\Dan\Dev\Unity Projects\MultiUnitPathfinding\Assets\danzabarr\DEMO\Scripts\Waypoint.cs", "C#", 37, 0, 0, 0, 3, 9, 49
"c:\Users\Dan\Dev\Unity Projects\MultiUnitPathfinding\Assets\danzabarr\Extensions\ScreenCast.cs", "C#", 61, 0, 0, 0, 0, 15, 76
"c:\Users\Dan\Dev\Unity Projects\MultiUnitPathfinding\Assets\danzabarr\Extensions\SerializableDictionary.cs", "C#", 50, 0, 0, 0, 2, 10, 62
"c:\Users\Dan\Dev\Unity Projects\MultiUnitPathfinding\Assets\danzabarr\Extensions\SerializableHashSet.cs", "C#", 28, 0, 0, 0, 2, 7, 37
"c:\Users\Dan\Dev\Unity Projects\MultiUnitPathfinding\Assets\danzabarr\Extensions\VectorExtensions.cs", "C#", 55, 0, 0, 0, 7, 15, 77
"c:\Users\Dan\Dev\Unity Projects\MultiUnitPathfinding\Assets\danzabarr\Navigation\IAgent.cs", "C#", 10, 0, 0, 0, 23, 6, 39
"c:\Users\Dan\Dev\Unity Projects\MultiUnitPathfinding\Assets\danzabarr\Navigation\IGraph.cs", "C#", 10, 0, 0, 0, 0, 2, 12
"c:\Users\Dan\Dev\Unity Projects\MultiUnitPathfinding\Assets\danzabarr\Navigation\IPath.cs", "C#", 12, 0, 0, 0, 0, 2, 14
"c:\Users\Dan\Dev\Unity Projects\MultiUnitPathfinding\Assets\danzabarr\Navigation\Obstruction.cs", "C#", 127, 0, 0, 0, 25, 32, 184
"c:\Users\Dan\Dev\Unity Projects\MultiUnitPathfinding\Assets\danzabarr\Navigation\ObstructionArray.cs", "C#", 47, 0, 0, 0, 0, 9, 56
"c:\Users\Dan\Dev\Unity Projects\MultiUnitPathfinding\Assets\danzabarr\Navigation\ObstructionList.cs", "C#", 20, 0, 0, 0, 0, 4, 24
"c:\Users\Dan\Dev\Unity Projects\MultiUnitPathfinding\Assets\danzabarr\Navigation\ObstructionRect.cs", "C#", 28, 0, 0, 0, 0, 9, 37
"c:\Users\Dan\Dev\Unity Projects\MultiUnitPathfinding\Assets\danzabarr\Navigation\ObstructionSet.cs", "C#", 24, 0, 0, 0, 0, 5, 29
"c:\Users\Dan\Dev\Unity Projects\MultiUnitPathfinding\Assets\danzabarr\Navigation\PriorityQueue.cs", "C#", 60, 0, 0, 0, 1, 11, 72
"c:\Users\Dan\Dev\Unity Projects\MultiUnitPathfinding\Assets\danzabarr\Navigation\Search.cs", "C#", 186, 0, 0, 0, 1, 57, 244
"c:\Users\Dan\Dev\Unity Projects\MultiUnitPathfinding\Assets\danzabarr\Navigation\VoxelTraversal.cs", "C#", 190, 0, 0, 0, 7, 46, 243
"c:\Users\Dan\Dev\Unity Projects\MultiUnitPathfinding\Assets\danzabarr\Toon\Scripts\PostProcessingEffect.cs", "C#", 19, 0, 0, 0, 0, 5, 24
"c:\Users\Dan\Dev\Unity Projects\MultiUnitPathfinding\Assets\danzabarr\Toon\Shaders\CustomTessellation.cginc", "UnityShader", 0, 61, 0, 0, 4, 12, 77
"c:\Users\Dan\Dev\Unity Projects\MultiUnitPathfinding\Assets\danzabarr\Toon\Shaders\Grass.shader", "UnityShader", 0, 219, 0, 0, 31, 69, 319
"c:\Users\Dan\Dev\Unity Projects\MultiUnitPathfinding\Assets\danzabarr\Toon\Shaders\Pixelated.shader", "UnityShader", 0, 79, 0, 0, 9, 20, 108
"c:\Users\Dan\Dev\Unity Projects\MultiUnitPathfinding\Assets\danzabarr\Toon\Shaders\Solid.shader", "UnityShader", 0, 62, 0, 0, 0, 12, 74
"c:\Users\Dan\Dev\Unity Projects\MultiUnitPathfinding\Assets\danzabarr\Toon\Shaders\Terrain.shader", "UnityShader", 0, 67, 0, 0, 0, 15, 82
"c:\Users\Dan\Dev\Unity Projects\MultiUnitPathfinding\Assets\danzabarr\Toon\Shaders\Textured.shader", "UnityShader", 0, 68, 0, 0, 0, 10, 78
"c:\Users\Dan\Dev\Unity Projects\MultiUnitPathfinding\Assets\danzabarr\pxl-UI\Scripts\DialogueBox.cs", "C#", 135, 0, 0, 0, 54, 31, 220
"c:\Users\Dan\Dev\Unity Projects\MultiUnitPathfinding\Packages\manifest.json", "JSON", 0, 0, 45, 0, 0, 1, 46
"c:\Users\Dan\Dev\Unity Projects\MultiUnitPathfinding\Packages\packages-lock.json", "JSON", 0, 0, 430, 0, 0, 1, 431
"c:\Users\Dan\Dev\Unity Projects\MultiUnitPathfinding\README.md", "Markdown", 0, 0, 0, 1, 0, 2, 3
"Total", "-", 4181, 3237, 630, 1, 711, 1822, 10582