"filename", "language", "UnityShader", "C#", "JSON", "Markdown", "comment", "blank", "total"
"c:\Users\Dan\Dev\Unity Projects\MultiUnitPathfinding\Assets\AurynSky\Desert Pack\Scripts\ChestDemo.cs", "C#", 0, 19, 0, 0, 9, 8, 36
"c:\Users\Dan\Dev\Unity Projects\MultiUnitPathfinding\Assets\AurynSky\Desert Pack\Scripts\MaterialMover.cs", "C#", 0, 17, 0, 0, 0, 2, 19
"c:\Users\Dan\Dev\Unity Projects\MultiUnitPathfinding\Assets\AurynSky\Desert Pack\Scripts\Rotator.cs", "C#", 0, 11, 0, 0, 1, 5, 17
"c:\Users\Dan\Dev\Unity Projects\MultiUnitPathfinding\Assets\IronWarrior ToonWaterShader master Assets\Scripts\CameraDepthTextureMode.cs", "C#", 0, 18, 0, 0, 0, 5, 23
"c:\Users\Dan\Dev\Unity Projects\MultiUnitPathfinding\Assets\IronWarrior ToonWaterShader master Assets\Scripts\NormalsReplacementShader.cs", "C#", 0, 21, 0, 0, 3, 6, 30
"c:\Users\Dan\Dev\Unity Projects\MultiUnitPathfinding\Assets\IronWarrior ToonWaterShader master Assets\Scripts\WaterBob.cs", "C#", 0, 19, 0, 0, 0, 7, 26
"c:\Users\Dan\Dev\Unity Projects\MultiUnitPathfinding\Assets\IronWarrior ToonWaterShader master Assets\Shaders\HiddenNormalsTexture.shader", "UnityShader", 44, 0, 0, 0, 0, 8, 52
"c:\Users\Dan\Dev\Unity Projects\MultiUnitPathfinding\Assets\IronWarrior ToonWaterShader master Assets\Shaders\ToonLit.shader", "UnityShader", 56, 0, 0, 0, 0, 11, 67
"c:\Users\Dan\Dev\Unity Projects\MultiUnitPathfinding\Assets\IronWarrior ToonWaterShader master Assets\Shaders\ToonWater.shader", "UnityShader", 106, 0, 0, 0, 34, 42, 182
"c:\Users\Dan\Dev\Unity Projects\MultiUnitPathfinding\Assets\IronWarrior ToonWaterShader master Assets\Shaders\UnlitShadowCaster.shader", "UnityShader", 49, 0, 0, 0, 0, 10, 59
"c:\Users\Dan\Dev\Unity Projects\MultiUnitPathfinding\Assets\Quirky Series Ultimate\_Scripts\QuirkySeriesDemo.cs", "C#", 0, 180, 0, 0, 19, 34, 233
"c:\Users\Dan\Dev\Unity Projects\MultiUnitPathfinding\Assets\Quirky Series Ultimate\_Scripts\RotateOnScroll.cs", "C#", 0, 15, 0, 0, 1, 4, 20
"c:\Users\Dan\Dev\Unity Projects\MultiUnitPathfinding\Assets\Quirky Series Ultimate\_Shader\SoftSurface.shader", "UnityShader", 33, 0, 0, 0, 1, 5, 39
"c:\Users\Dan\Dev\Unity Projects\MultiUnitPathfinding\Assets\Quirky Series Ultimate\_Shader\ToonRamp.shader", "UnityShader", 46, 0, 0, 0, 6, 11, 63
"c:\Users\Dan\Dev\Unity Projects\MultiUnitPathfinding\Assets\Supercyan Character Pack Free Sample\Scripts\AccessoryLogic.cs", "C#", 0, 11, 0, 0, 0, 3, 14
"c:\Users\Dan\Dev\Unity Projects\MultiUnitPathfinding\Assets\Supercyan Character Pack Free Sample\Scripts\AccessoryWearLogic.cs", "C#", 0, 95, 0, 0, 0, 15, 110
"c:\Users\Dan\Dev\Unity Projects\MultiUnitPathfinding\Assets\Supercyan Character Pack Free Sample\Scripts\DemoFree.cs", "C#", 0, 72, 0, 0, 0, 21, 93
"c:\Users\Dan\Dev\Unity Projects\MultiUnitPathfinding\Assets\Supercyan Character Pack Free Sample\Scripts\FreeCameraLogic.cs", "C#", 0, 48, 0, 0, 0, 13, 61
"c:\Users\Dan\Dev\Unity Projects\MultiUnitPathfinding\Assets\Supercyan Character Pack Free Sample\Scripts\SimpleSampleCharacterControl.cs", "C#", 0, 208, 0, 0, 8, 45, 261
"c:\Users\Dan\Dev\Unity Projects\MultiUnitPathfinding\Assets\Supercyan Character Pack Free Sample\Shaders\Legacy\CelShader.shader", "UnityShader", 203, 0, 0, 0, 70, 9, 282
"c:\Users\Dan\Dev\Unity Projects\MultiUnitPathfinding\Assets\Supercyan Character Pack Free Sample\Shaders\SupercyanShader.shader", "UnityShader", 33, 0, 0, 0, 0, 6, 39
"c:\Users\Dan\Dev\Unity Projects\MultiUnitPathfinding\Assets\Supercyan Character Pack Free Sample\Shaders\SupercyanShaderLighting.cginc", "UnityShader", 28, 0, 0, 0, 0, 10, 38
"c:\Users\Dan\Dev\Unity Projects\MultiUnitPathfinding\Assets\TextMesh Pro\Shaders\TMP_Bitmap-Custom-Atlas.shader", "UnityShader", 109, 0, 0, 0, 2, 33, 144
"c:\Users\Dan\Dev\Unity Projects\MultiUnitPathfinding\Assets\TextMesh Pro\Shaders\TMP_Bitmap-Mobile.shader", "UnityShader", 112, 0, 0, 0, 3, 31, 146
"c:\Users\Dan\Dev\Unity Projects\MultiUnitPathfinding\Assets\TextMesh Pro\Shaders\TMP_Bitmap.shader", "UnityShader", 109, 0, 0, 0, 2, 33, 144
"c:\Users\Dan\Dev\Unity Projects\MultiUnitPathfinding\Assets\TextMesh Pro\Shaders\TMP_SDF Overlay.shader", "UnityShader", 243, 0, 0, 0, 4, 71, 318
"c:\Users\Dan\Dev\Unity Projects\MultiUnitPathfinding\Assets\TextMesh Pro\Shaders\TMP_SDF SSD.shader", "UnityShader", 241, 0, 0, 0, 4, 66, 311
"c:\Users\Dan\Dev\Unity Projects\MultiUnitPathfinding\Assets\TextMesh Pro\Shaders\TMP_SDF-Mobile Masking.shader", "UnityShader", 188, 0, 0, 0, 10, 50, 248
"c:\Users\Dan\Dev\Unity Projects\MultiUnitPathfinding\Assets\TextMesh Pro\Shaders\TMP_SDF-Mobile Overlay.shader", "UnityShader", 183, 0, 0, 0, 8, 50, 241
"c:\Users\Dan\Dev\Unity Projects\MultiUnitPathfinding\Assets\TextMesh Pro\Shaders\TMP_SDF-Mobile SSD.shader", "UnityShader", 82, 0, 0, 0, 4, 21, 107
"c:\Users\Dan\Dev\Unity Projects\MultiUnitPathfinding\Assets\TextMesh Pro\Shaders\TMP_SDF-Mobile.shader", "UnityShader", 183, 0, 0, 0, 8, 50, 241
"c:\Users\Dan\Dev\Unity Projects\MultiUnitPathfinding\Assets\TextMesh Pro\Shaders\TMP_SDF-Surface-Mobile.shader", "UnityShader", 103, 0, 0, 0, 8, 28, 139
"c:\Users\Dan\Dev\Unity Projects\MultiUnitPathfinding\Assets\TextMesh Pro\Shaders\TMP_SDF-Surface.shader", "UnityShader", 122, 0, 0, 0, 4, 33, 159
"c:\Users\Dan\Dev\Unity Projects\MultiUnitPathfinding\Assets\TextMesh Pro\Shaders\TMP_SDF.shader", "UnityShader", 243, 0, 0, 0, 4, 71, 318
"c:\Users\Dan\Dev\Unity Projects\MultiUnitPathfinding\Assets\TextMesh Pro\Shaders\TMP_Sprite.shader", "UnityShader", 97, 0, 0, 0, 0, 20, 117
"c:\Users\Dan\Dev\Unity Projects\MultiUnitPathfinding\Assets\TextMesh Pro\Shaders\TMPro.cginc", "UnityShader", 63, 0, 0, 0, 2, 20, 85
"c:\Users\Dan\Dev\Unity Projects\MultiUnitPathfinding\Assets\TextMesh Pro\Shaders\TMPro_Mobile.cginc", "UnityShader", 122, 0, 0, 0, 2, 34, 158
"c:\Users\Dan\Dev\Unity Projects\MultiUnitPathfinding\Assets\TextMesh Pro\Shaders\TMPro_Properties.cginc", "UnityShader", 62, 0, 0, 0, 10, 14, 86
"c:\Users\Dan\Dev\Unity Projects\MultiUnitPathfinding\Assets\TextMesh Pro\Shaders\TMPro_Surface.cginc", "UnityShader", 76, 0, 0, 0, 7, 19, 102
"c:\Users\Dan\Dev\Unity Projects\MultiUnitPathfinding\Assets\TextMesh Pro\Sprites\EmojiOne.json", "JSON", 0, 0, 155, 0, 0, 2, 157
"c:\Users\Dan\Dev\Unity Projects\MultiUnitPathfinding\Assets\danzabarr\DEMO\Editor\DecorationsEditor.cs", "C#", 0, 17, 0, 0, 0, 5, 22
"c:\Users\Dan\Dev\Unity Projects\MultiUnitPathfinding\Assets\danzabarr\DEMO\Editor\MapEditor.cs", "C#", 0, 17, 0, 0, 0, 5, 22
"c:\Users\Dan\Dev\Unity Projects\MultiUnitPathfinding\Assets\danzabarr\DEMO\Scripts\AbstractTerrainGenerator.cs", "C#", 0, 85, 0, 0, 41, 24, 150
"c:\Users\Dan\Dev\Unity Projects\MultiUnitPathfinding\Assets\danzabarr\DEMO\Scripts\Actor.cs", "C#", 0, 40, 0, 0, 5, 9, 54
"c:\Users\Dan\Dev\Unity Projects\MultiUnitPathfinding\Assets\danzabarr\DEMO\Scripts\Agent.cs", "C#", 0, 98, 0, 0, 0, 26, 124
"c:\Users\Dan\Dev\Unity Projects\MultiUnitPathfinding\Assets\danzabarr\DEMO\Scripts\AgentTask.cs", "C#", 0, 9, 0, 0, 0, 2, 11
"c:\Users\Dan\Dev\Unity Projects\MultiUnitPathfinding\Assets\danzabarr\DEMO\Scripts\Area.cs", "C#", 0, 54, 0, 0, 6, 15, 75
"c:\Users\Dan\Dev\Unity Projects\MultiUnitPathfinding\Assets\danzabarr\DEMO\Scripts\BatchRenderer.cs", "C#", 0, 62, 0, 0, 3, 14, 79
"c:\Users\Dan\Dev\Unity Projects\MultiUnitPathfinding\Assets\danzabarr\DEMO\Scripts\Boid.cs", "C#", 0, 63, 0, 0, 2, 13, 78
"c:\Users\Dan\Dev\Unity Projects\MultiUnitPathfinding\Assets\danzabarr\DEMO\Scripts\Bridge.cs", "C#", 0, 28, 0, 0, 0, 5, 33
"c:\Users\Dan\Dev\Unity Projects\MultiUnitPathfinding\Assets\danzabarr\DEMO\Scripts\CameraController.cs", "C#", 0, 54, 0, 0, 7, 17, 78
"c:\Users\Dan\Dev\Unity Projects\MultiUnitPathfinding\Assets\danzabarr\DEMO\Scripts\CharacterControllerTest.cs", "C#", 0, 30, 0, 0, 4, 11, 45
"c:\Users\Dan\Dev\Unity Projects\MultiUnitPathfinding\Assets\danzabarr\DEMO\Scripts\Chunk.cs", "C#", 0, 272, 0, 0, 20, 58, 350
"c:\Users\Dan\Dev\Unity Projects\MultiUnitPathfinding\Assets\danzabarr\DEMO\Scripts\CliffDecorations.cs", "C#", 0, 44, 0, 0, 3, 11, 58
"c:\Users\Dan\Dev\Unity Projects\MultiUnitPathfinding\Assets\danzabarr\DEMO\Scripts\CollisionTest.cs", "C#", 0, 239, 0, 0, 7, 57, 303
"c:\Users\Dan\Dev\Unity Projects\MultiUnitPathfinding\Assets\danzabarr\DEMO\Scripts\Decorations.cs", "C#", 0, 114, 0, 0, 10, 32, 156
"c:\Users\Dan\Dev\Unity Projects\MultiUnitPathfinding\Assets\danzabarr\DEMO\Scripts\Dialogue.cs", "C#", 0, 187, 0, 0, 23, 38, 248
"c:\Users\Dan\Dev\Unity Projects\MultiUnitPathfinding\Assets\danzabarr\DEMO\Scripts\IHeightMap.cs", "C#", 0, 7, 0, 0, 0, 3, 10
"c:\Users\Dan\Dev\Unity Projects\MultiUnitPathfinding\Assets\danzabarr\DEMO\Scripts\IOnValidateListener.cs", "C#", 0, 7, 0, 0, 1, 2, 10
"c:\Users\Dan\Dev\Unity Projects\MultiUnitPathfinding\Assets\danzabarr\DEMO\Scripts\Map.cs", "C#", 0, 201, 0, 0, 26, 39, 266
"c:\Users\Dan\Dev\Unity Projects\MultiUnitPathfinding\Assets\danzabarr\DEMO\Scripts\MapGeneratorBase.cs", "C#", 0, 950, 0, 0, 103, 266, 1319
"c:\Users\Dan\Dev\Unity Projects\MultiUnitPathfinding\Assets\danzabarr\DEMO\Scripts\Node.cs", "C#", 0, 14, 0, 0, 0, 3, 17
"c:\Users\Dan\Dev\Unity Projects\MultiUnitPathfinding\Assets\danzabarr\DEMO\Scripts\NoiseSettings.cs", "C#", 0, 57, 0, 0, 0, 12, 69
"c:\Users\Dan\Dev\Unity Projects\MultiUnitPathfinding\Assets\danzabarr\DEMO\Scripts\PerlinNoise.cs", "C#", 0, 39, 0, 0, 0, 8, 47
"c:\Users\Dan\Dev\Unity Projects\MultiUnitPathfinding\Assets\danzabarr\DEMO\Scripts\Ramp.cs", "C#", 0, 56, 0, 0, 0, 10, 66
"c:\Users\Dan\Dev\Unity Projects\MultiUnitPathfinding\Assets\danzabarr\DEMO\Scripts\RandomTransform.cs", "C#", 0, 91, 0, 0, 1, 13, 105
"c:\Users\Dan\Dev\Unity Projects\MultiUnitPathfinding\Assets\danzabarr\DEMO\Scripts\ScriptElementPatterns.cs", "C#", 0, 69, 0, 0, 2, 14, 85
"c:\Users\Dan\Dev\Unity Projects\MultiUnitPathfinding\Assets\danzabarr\DEMO\Scripts\TerrainGenerationSettings.cs", "C#", 0, 32, 0, 0, 1, 8, 41
"c:\Users\Dan\Dev\Unity Projects\MultiUnitPathfinding\Assets\danzabarr\DEMO\Scripts\Waypoint.cs", "C#", 0, 37, 0, 0, 3, 9, 49
"c:\Users\Dan\Dev\Unity Projects\MultiUnitPathfinding\Assets\danzabarr\Extensions\Editor\AddTriggersToStates.cs", "C#", 0, 31, 0, 0, 5, 4, 40
"c:\Users\Dan\Dev\Unity Projects\MultiUnitPathfinding\Assets\danzabarr\Extensions\ScreenCast.cs", "C#", 0, 61, 0, 0, 0, 15, 76
"c:\Users\Dan\Dev\Unity Projects\MultiUnitPathfinding\Assets\danzabarr\Extensions\SerializableDictionary.cs", "C#", 0, 50, 0, 0, 2, 10, 62
"c:\Users\Dan\Dev\Unity Projects\MultiUnitPathfinding\Assets\danzabarr\Extensions\SerializableHashSet.cs", "C#", 0, 27, 0, 0, 2, 7, 36
"c:\Users\Dan\Dev\Unity Projects\MultiUnitPathfinding\Assets\danzabarr\Extensions\VectorExtensions.cs", "C#", 0, 55, 0, 0, 7, 15, 77
"c:\Users\Dan\Dev\Unity Projects\MultiUnitPathfinding\Assets\danzabarr\Navigation\IAgent.cs", "C#", 0, 10, 0, 0, 23, 6, 39
"c:\Users\Dan\Dev\Unity Projects\MultiUnitPathfinding\Assets\danzabarr\Navigation\IGraph.cs", "C#", 0, 10, 0, 0, 0, 2, 12
"c:\Users\Dan\Dev\Unity Projects\MultiUnitPathfinding\Assets\danzabarr\Navigation\IPath.cs", "C#", 0, 12, 0, 0, 0, 2, 14
"c:\Users\Dan\Dev\Unity Projects\MultiUnitPathfinding\Assets\danzabarr\Navigation\Obstruction.cs", "C#", 0, 148, 0, 0, 23, 30, 201
"c:\Users\Dan\Dev\Unity Projects\MultiUnitPathfinding\Assets\danzabarr\Navigation\ObstructionArray.cs", "C#", 0, 47, 0, 0, 0, 9, 56
"c:\Users\Dan\Dev\Unity Projects\MultiUnitPathfinding\Assets\danzabarr\Navigation\ObstructionList.cs", "C#", 0, 20, 0, 0, 0, 4, 24
"c:\Users\Dan\Dev\Unity Projects\MultiUnitPathfinding\Assets\danzabarr\Navigation\ObstructionRect.cs", "C#", 0, 30, 0, 0, 0, 9, 39
"c:\Users\Dan\Dev\Unity Projects\MultiUnitPathfinding\Assets\danzabarr\Navigation\ObstructionSet.cs", "C#", 0, 24, 0, 0, 0, 5, 29
"c:\Users\Dan\Dev\Unity Projects\MultiUnitPathfinding\Assets\danzabarr\Navigation\PriorityQueue.cs", "C#", 0, 60, 0, 0, 1, 11, 72
"c:\Users\Dan\Dev\Unity Projects\MultiUnitPathfinding\Assets\danzabarr\Navigation\Search.cs", "C#", 0, 186, 0, 0, 1, 57, 244
"c:\Users\Dan\Dev\Unity Projects\MultiUnitPathfinding\Assets\danzabarr\Navigation\VoxelTraversal.cs", "C#", 0, 190, 0, 0, 7, 46, 243
"c:\Users\Dan\Dev\Unity Projects\MultiUnitPathfinding\Assets\danzabarr\Toon\Scripts\PostProcessingEffect.cs", "C#", 0, 21, 0, 0, 1, 6, 28
"c:\Users\Dan\Dev\Unity Projects\MultiUnitPathfinding\Assets\danzabarr\Toon\Shaders\CustomTessellation.cginc", "UnityShader", 61, 0, 0, 0, 4, 12, 77
"c:\Users\Dan\Dev\Unity Projects\MultiUnitPathfinding\Assets\danzabarr\Toon\Shaders\Grass.shader", "UnityShader", 226, 0, 0, 0, 32, 70, 328
"c:\Users\Dan\Dev\Unity Projects\MultiUnitPathfinding\Assets\danzabarr\Toon\Shaders\Pixelated.shader", "UnityShader", 102, 0, 0, 0, 11, 26, 139
"c:\Users\Dan\Dev\Unity Projects\MultiUnitPathfinding\Assets\danzabarr\Toon\Shaders\Solid.shader", "UnityShader", 62, 0, 0, 0, 0, 12, 74
"c:\Users\Dan\Dev\Unity Projects\MultiUnitPathfinding\Assets\danzabarr\Toon\Shaders\Terrain.shader", "UnityShader", 67, 0, 0, 0, 0, 15, 82
"c:\Users\Dan\Dev\Unity Projects\MultiUnitPathfinding\Assets\danzabarr\Toon\Shaders\Textured.shader", "UnityShader", 68, 0, 0, 0, 0, 10, 78
"c:\Users\Dan\Dev\Unity Projects\MultiUnitPathfinding\Assets\danzabarr\Toon\Shaders\Water.shader", "UnityShader", 16, 0, 0, 0, 1, 4, 21
"c:\Users\Dan\Dev\Unity Projects\MultiUnitPathfinding\Assets\danzabarr\pxl-UI\Scripts\DialogueBox.cs", "C#", 0, 135, 0, 0, 54, 31, 220
"c:\Users\Dan\Dev\Unity Projects\MultiUnitPathfinding\Packages\manifest.json", "JSON", 0, 0, 45, 0, 0, 1, 46
"c:\Users\Dan\Dev\Unity Projects\MultiUnitPathfinding\Packages\packages-lock.json", "JSON", 0, 0, 430, 0, 0, 1, 431
"c:\Users\Dan\Dev\Unity Projects\MultiUnitPathfinding\README.md", "Markdown", 0, 0, 0, 1, 0, 2, 3
"Total", "-", 3538, 4824, 630, 1, 676, 2077, 11746