"filename", "language", "C#", "UnityShader", "comment", "blank", "total"
"c:\Users\Dan\Dev\Unity Projects\MultiUnitPathfinding\Assets\danzabarr\DEMO\Editor\DecorationsEditor.cs", "C#", 17, 0, 0, 5, 22
"c:\Users\Dan\Dev\Unity Projects\MultiUnitPathfinding\Assets\danzabarr\DEMO\Editor\MapEditor.cs", "C#", 17, 0, 0, 5, 22
"c:\Users\Dan\Dev\Unity Projects\MultiUnitPathfinding\Assets\danzabarr\DEMO\Scripts\AbstractTerrainGenerator.cs", "C#", 85, 0, 41, 24, 150
"c:\Users\Dan\Dev\Unity Projects\MultiUnitPathfinding\Assets\danzabarr\DEMO\Scripts\Agent.cs", "C#", 53, 0, 0, 15, 68
"c:\Users\Dan\Dev\Unity Projects\MultiUnitPathfinding\Assets\danzabarr\DEMO\Scripts\AgentTask.cs", "C#", 9, 0, 0, 2, 11
"c:\Users\Dan\Dev\Unity Projects\MultiUnitPathfinding\Assets\danzabarr\DEMO\Scripts\Area.cs", "C#", 54, 0, 6, 15, 75
"c:\Users\Dan\Dev\Unity Projects\MultiUnitPathfinding\Assets\danzabarr\DEMO\Scripts\BatchRenderer.cs", "C#", 62, 0, 3, 14, 79
"c:\Users\Dan\Dev\Unity Projects\MultiUnitPathfinding\Assets\danzabarr\DEMO\Scripts\Boid.cs", "C#", 63, 0, 2, 13, 78
"c:\Users\Dan\Dev\Unity Projects\MultiUnitPathfinding\Assets\danzabarr\DEMO\Scripts\CameraController.cs", "C#", 54, 0, 4, 15, 73
"c:\Users\Dan\Dev\Unity Projects\MultiUnitPathfinding\Assets\danzabarr\DEMO\Scripts\CharacterControllerTest.cs", "C#", 30, 0, 4, 11, 45
"c:\Users\Dan\Dev\Unity Projects\MultiUnitPathfinding\Assets\danzabarr\DEMO\Scripts\Chunk.cs", "C#", 256, 0, 151, 56, 463
"c:\Users\Dan\Dev\Unity Projects\MultiUnitPathfinding\Assets\danzabarr\DEMO\Scripts\CliffDecorations.cs", "C#", 44, 0, 3, 11, 58
"c:\Users\Dan\Dev\Unity Projects\MultiUnitPathfinding\Assets\danzabarr\DEMO\Scripts\CollisionTest.cs", "C#", 239, 0, 7, 57, 303
"c:\Users\Dan\Dev\Unity Projects\MultiUnitPathfinding\Assets\danzabarr\DEMO\Scripts\Decorations.cs", "C#", 115, 0, 8, 31, 154
"c:\Users\Dan\Dev\Unity Projects\MultiUnitPathfinding\Assets\danzabarr\DEMO\Scripts\Dialogue.cs", "C#", 187, 0, 23, 38, 248
"c:\Users\Dan\Dev\Unity Projects\MultiUnitPathfinding\Assets\danzabarr\DEMO\Scripts\IHeightMap.cs", "C#", 7, 0, 0, 3, 10
"c:\Users\Dan\Dev\Unity Projects\MultiUnitPathfinding\Assets\danzabarr\DEMO\Scripts\IOnValidateListener.cs", "C#", 7, 0, 1, 2, 10
"c:\Users\Dan\Dev\Unity Projects\MultiUnitPathfinding\Assets\danzabarr\DEMO\Scripts\Map.cs", "C#", 191, 0, 26, 35, 252
"c:\Users\Dan\Dev\Unity Projects\MultiUnitPathfinding\Assets\danzabarr\DEMO\Scripts\MapGeneratorBase.cs", "C#", 644, 0, 77, 168, 889
"c:\Users\Dan\Dev\Unity Projects\MultiUnitPathfinding\Assets\danzabarr\DEMO\Scripts\Node.cs", "C#", 14, 0, 0, 3, 17
"c:\Users\Dan\Dev\Unity Projects\MultiUnitPathfinding\Assets\danzabarr\DEMO\Scripts\NoiseSettings.cs", "C#", 55, 0, 0, 12, 67
"c:\Users\Dan\Dev\Unity Projects\MultiUnitPathfinding\Assets\danzabarr\DEMO\Scripts\PerlinNoise.cs", "C#", 43, 0, 0, 8, 51
"c:\Users\Dan\Dev\Unity Projects\MultiUnitPathfinding\Assets\danzabarr\DEMO\Scripts\Ramp.cs", "C#", 56, 0, 0, 10, 66
"c:\Users\Dan\Dev\Unity Projects\MultiUnitPathfinding\Assets\danzabarr\DEMO\Scripts\RandomTransform.cs", "C#", 92, 0, 0, 13, 105
"c:\Users\Dan\Dev\Unity Projects\MultiUnitPathfinding\Assets\danzabarr\DEMO\Scripts\ScriptElementPatterns.cs", "C#", 69, 0, 2, 14, 85
"c:\Users\Dan\Dev\Unity Projects\MultiUnitPathfinding\Assets\danzabarr\DEMO\Scripts\TerrainGenerationSettings.cs", "C#", 26, 0, 0, 5, 31
"c:\Users\Dan\Dev\Unity Projects\MultiUnitPathfinding\Assets\danzabarr\DEMO\Scripts\Waypoint.cs", "C#", 29, 0, 0, 5, 34
"c:\Users\Dan\Dev\Unity Projects\MultiUnitPathfinding\Assets\danzabarr\Extensions\ScreenCast.cs", "C#", 61, 0, 0, 15, 76
"c:\Users\Dan\Dev\Unity Projects\MultiUnitPathfinding\Assets\danzabarr\Extensions\SerializableDictionary.cs", "C#", 50, 0, 2, 10, 62
"c:\Users\Dan\Dev\Unity Projects\MultiUnitPathfinding\Assets\danzabarr\Extensions\SerializableHashSet.cs", "C#", 28, 0, 2, 7, 37
"c:\Users\Dan\Dev\Unity Projects\MultiUnitPathfinding\Assets\danzabarr\Extensions\VectorExtensions.cs", "C#", 55, 0, 7, 15, 77
"c:\Users\Dan\Dev\Unity Projects\MultiUnitPathfinding\Assets\danzabarr\Navigation\IAgent.cs", "C#", 10, 0, 23, 6, 39
"c:\Users\Dan\Dev\Unity Projects\MultiUnitPathfinding\Assets\danzabarr\Navigation\IGraph.cs", "C#", 10, 0, 0, 2, 12
"c:\Users\Dan\Dev\Unity Projects\MultiUnitPathfinding\Assets\danzabarr\Navigation\IPath.cs", "C#", 12, 0, 0, 2, 14
"c:\Users\Dan\Dev\Unity Projects\MultiUnitPathfinding\Assets\danzabarr\Navigation\Obstruction.cs", "C#", 127, 0, 25, 32, 184
"c:\Users\Dan\Dev\Unity Projects\MultiUnitPathfinding\Assets\danzabarr\Navigation\ObstructionArray.cs", "C#", 47, 0, 0, 9, 56
"c:\Users\Dan\Dev\Unity Projects\MultiUnitPathfinding\Assets\danzabarr\Navigation\ObstructionList.cs", "C#", 20, 0, 0, 4, 24
"c:\Users\Dan\Dev\Unity Projects\MultiUnitPathfinding\Assets\danzabarr\Navigation\ObstructionRect.cs", "C#", 28, 0, 0, 9, 37
"c:\Users\Dan\Dev\Unity Projects\MultiUnitPathfinding\Assets\danzabarr\Navigation\ObstructionSet.cs", "C#", 24, 0, 0, 5, 29
"c:\Users\Dan\Dev\Unity Projects\MultiUnitPathfinding\Assets\danzabarr\Navigation\PriorityQueue.cs", "C#", 60, 0, 1, 11, 72
"c:\Users\Dan\Dev\Unity Projects\MultiUnitPathfinding\Assets\danzabarr\Navigation\Search.cs", "C#", 186, 0, 1, 57, 244
"c:\Users\Dan\Dev\Unity Projects\MultiUnitPathfinding\Assets\danzabarr\Navigation\VoxelTraversal.cs", "C#", 190, 0, 7, 46, 243
"c:\Users\Dan\Dev\Unity Projects\MultiUnitPathfinding\Assets\danzabarr\Toon\Scripts\PostProcessingEffect.cs", "C#", 19, 0, 0, 5, 24
"c:\Users\Dan\Dev\Unity Projects\MultiUnitPathfinding\Assets\danzabarr\Toon\Shaders\CustomTessellation.cginc", "UnityShader", 0, 61, 4, 12, 77
"c:\Users\Dan\Dev\Unity Projects\MultiUnitPathfinding\Assets\danzabarr\Toon\Shaders\Grass.shader", "UnityShader", 0, 219, 31, 69, 319
"c:\Users\Dan\Dev\Unity Projects\MultiUnitPathfinding\Assets\danzabarr\Toon\Shaders\Pixelated.shader", "UnityShader", 0, 79, 9, 20, 108
"c:\Users\Dan\Dev\Unity Projects\MultiUnitPathfinding\Assets\danzabarr\Toon\Shaders\Solid.shader", "UnityShader", 0, 62, 0, 12, 74
"c:\Users\Dan\Dev\Unity Projects\MultiUnitPathfinding\Assets\danzabarr\Toon\Shaders\Terrain.shader", "UnityShader", 0, 67, 0, 15, 82
"c:\Users\Dan\Dev\Unity Projects\MultiUnitPathfinding\Assets\danzabarr\Toon\Shaders\Textured.shader", "UnityShader", 0, 68, 0, 10, 78
"c:\Users\Dan\Dev\Unity Projects\MultiUnitPathfinding\Assets\danzabarr\pxl-UI\Scripts\DialogueBox.cs", "C#", 135, 0, 54, 31, 220
"Total", "-", 3580, 556, 524, 994, 5654